40 22
0 0 0 0 0 0 0 0 0 0 0 0 0 0 0 0 0 0 0 0 0 0 0 0 0 0 0 0 0 0 0 0 0 0 0 0 0 0 0 0 
0 1 1 1 1 1 1 1 1 1 1 1 1 6 1 1 1 1 1 1 1 1 1 1 1 1 1 1 1 1 1 1 1 1 1 1 1 1 1 0 
0 2 2 2 2 2 2 2 2 2 2 2 2 5 2 2 2 2 2 2 2 2 1 1 1 1 1 1 1 1 1 1 1 1 1 1 1 1 1 0 
0 2 1 1 1 1 4 1 1 1 1 1 1 1 1 1 1 1 1 1 4 2 1 1 1 1 1 1 1 1 1 1 1 1 1 1 1 1 1 0 
0 2 1 2 5 2 1 2 2 2 2 2 2 5 2 2 2 2 2 2 1 2 1 1 1 1 1 1 1 1 1 1 1 1 1 1 1 1 1 0 
0 2 1 3 3 3 1 2 4 1 1 1 1 1 1 1 1 1 4 2 1 2 1 1 1 1 1 1 1 1 1 1 1 1 1 1 1 1 1 0 
0 2 1 3 3 3 1 2 1 2 2 2 2 5 2 2 2 2 1 2 1 2 1 1 1 1 1 1 1 1 1 1 1 1 1 1 1 1 1 0 
0 2 1 3 4 3 1 2 1 2 4 1 1 1 1 1 4 2 1 2 1 2 1 1 1 1 1 1 1 1 1 1 1 1 1 1 1 1 1 0 
0 2 1 3 4 3 1 2 1 2 1 2 2 5 2 2 1 2 1 2 1 2 1 1 1 1 1 1 1 1 1 1 1 1 1 1 1 1 1 0 
0 2 1 3 4 3 5 2 5 2 5 2 5 10 5 2 5 2 5 2 5 2 1 1 1 1 1 1 1 1 1 1 1 1 1 1 1 1 1 0 
0 2 1 3 3 3 1 2 1 2 1 2 1 1 1 2 1 2 1 2 1 2 1 1 1 1 1 1 1 1 1 1 1 1 1 1 1 1 1 0 
0 2 1 3 3 3 5 2 5 2 5 2 5 5 5 2 5 2 5 2 5 2 1 1 1 1 1 1 1 1 1 1 1 1 1 1 1 1 1 0 
0 2 1 3 3 3 1 2 1 2 1 2 2 2 2 2 1 2 1 2 1 2 1 1 1 1 1 1 1 1 1 1 1 1 1 1 1 1 1 0 
0 2 1 3 3 3 1 2 1 2 4 1 1 1 1 1 4 2 1 2 1 2 1 1 1 1 1 1 1 1 1 1 1 1 1 1 1 1 1 0 
0 2 1 3 3 3 1 2 1 2 2 2 2 2 2 2 2 2 1 2 1 2 1 1 1 1 1 1 1 1 1 1 1 1 1 1 1 1 1 0 
0 2 1 3 3 3 1 2 4 1 1 1 1 1 1 1 1 1 4 2 1 2 1 1 1 1 1 1 1 1 1 1 1 1 1 1 1 1 1 0 
0 2 1 3 3 3 1 2 2 2 2 2 2 2 2 2 2 2 2 2 1 2 1 1 1 1 1 1 1 1 1 1 1 1 1 1 1 1 1 0 
0 2 1 3 3 3 4 1 1 1 1 1 1 1 1 1 1 1 1 1 4 2 1 1 1 1 1 1 1 1 1 1 1 1 1 1 1 1 1 0 
0 2 2 2 2 2 1 1 2 2 2 2 2 2 2 2 2 2 2 2 2 2 1 1 1 1 1 1 1 1 1 1 1 1 1 1 1 1 1 0 
0 1 1 1 5 5 1 1 1 1 1 1 1 1 1 1 1 1 1 1 1 1 1 1 1 1 1 1 1 1 1 1 1 1 1 1 1 1 1 0 
0 1 1 1 5 5 1 1 1 1 1 1 1 1 1 1 1 1 1 1 1 1 1 1 1 1 1 1 1 1 1 1 1 1 1 1 1 1 1 0 
0 0 0 0 0 0 0 0 0 0 0 0 0 0 0 0 0 0 0 0 0 0 0 0 0 0 0 0 0 0 0 0 0 0 0 0 0 0 0 0 