40 22
0 0 0 0 0 0 0 0 0 0 0 0 0 0 0 0 0 0 0 0 0 0 0 0 0 0 0 0 0 0 0 0 0 0 0 0 0 0 0 0 
0 5 1 5 3 1 1 5 1 5 1 1 5 1 1 3 1 5 1 1 6 5 1 1 3 1 5 5 1 1 3 1 5 3 1 1 1 5 1 0 
0 1 3 1 3 3 1 1 1 1 1 1 5 1 1 3 1 1 1 3 1 1 1 1 5 1 1 1 3 1 1 1 1 1 4 3 1 3 1 0 
0 5 3 1 1 3 1 1 1 5 5 1 1 1 3 1 1 3 1 5 1 1 3 1 3 1 1 1 2 2 2 2 2 2 2 2 2 2 2 0 
0 1 1 1 4 5 1 1 3 1 5 4 1 1 1 1 1 3 1 1 1 1 1 5 1 1 1 1 1 1 1 1 3 3 5 3 1 1 3 0 
0 2 2 2 2 2 2 2 2 2 2 2 2 1 1 3 1 3 1 1 1 1 5 1 5 5 1 1 1 1 1 1 3 5 5 3 1 1 3 0 
0 1 5 5 1 1 1 5 1 1 3 1 5 5 1 1 3 1 5 5 1 1 1 1 5 3 3 3 1 1 1 1 1 5 5 3 1 1 5 0 
0 1 1 1 5 3 1 1 1 5 4 1 1 5 1 1 3 1 5 5 1 1 1 1 1 3 1 3 3 1 1 3 1 5 1 5 3 1 1 0 
0 1 1 3 1 5 1 1 3 1 5 3 1 1 1 1 5 1 1 1 1 1 5 1 1 1 3 5 3 1 1 3 1 1 1 1 5 1 1 0 
0 1 1 1 1 1 3 5 1 1 1 1 1 1 5 1 5 5 4 3 3 1 5 1 1 1 5 5 3 1 1 5 1 3 1 1 1 1 3 0 
0 3 1 3 1 1 1 5 1 5 3 1 1 1 1 1 1 5 1 1 3 1 1 1 3 1 1 1 1 3 1 1 1 1 4 3 1 5 5 0 
0 1 1 1 1 1 1 3 1 5 3 1 1 1 1 1 1 1 1 1 5 3 1 1 3 1 1 1 2 2 2 2 2 2 2 2 2 2 2 0 
0 1 3 3 1 1 1 1 1 1 5 1 1 3 1 5 1 1 1 5 1 1 3 1 5 5 1 1 3 1 5 5 1 1 1 5 3 1 1 0 
0 2 2 2 2 2 2 2 2 2 2 2 2 3 1 1 1 1 1 1 1 1 5 1 1 1 3 1 1 1 1 1 1 3 1 3 3 1 1 0 
0 1 1 3 1 1 1 5 5 1 1 1 4 1 1 3 1 5 1 1 3 1 3 3 1 1 1 1 1 1 1 1 1 3 1 3 3 1 1 0 
0 1 1 5 1 1 3 1 5 1 3 1 1 1 5 5 5 5 5 5 5 5 1 1 1 1 1 1 1 1 1 5 5 3 1 1 3 1 1 0 
0 3 1 1 5 3 1 1 1 1 3 1 1 3 5 3 1 1 1 4 5 1 1 5 1 1 1 1 1 1 1 5 5 3 1 1 3 1 10 0 
0 5 1 1 1 5 1 1 3 1 5 1 1 1 3 1 5 5 1 1 1 1 1 3 3 3 3 1 1 3 1 5 1 5 3 1 1 5 3 0 
0 1 5 3 1 1 4 1 3 1 1 1 1 5 1 5 5 1 1 1 1 1 1 3 3 5 3 1 1 3 1 1 1 5 5 1 1 1 3 0 
0 3 1 5 5 1 1 3 1 5 5 1 1 1 1 1 3 1 3 1 5 1 1 1 5 5 3 1 1 3 1 1 1 1 5 1 1 1 3 0 
0 1 1 1 5 5 1 3 1 3 5 1 1 1 1 1 3 1 3 1 1 1 1 1 5 5 5 1 1 5 1 3 1 1 1 1 3 1 1 0 
0 0 0 0 0 0 0 0 0 0 0 0 0 0 0 0 0 0 0 0 0 0 0 0 0 0 0 0 0 0 0 0 0 0 0 0 0 0 0 0 