40 22
0 0 0 0 0 0 0 0 0 0 0 0 0 0 0 0 0 0 0 0 0 0 0 0 0 0 0 0 0 0 0 0 0 0 0 0 0 0 0 0 
0 2 2 2 2 2 2 2 2 2 1 1 1 1 3 1 3 1 1 3 1 1 1 1 1 1 1 1 3 1 2 2 2 2 2 2 2 2 2 0 
0 5 5 5 5 5 5 5 5 5 1 1 1 1 1 1 1 1 1 1 1 3 1 1 1 1 3 1 1 1 5 5 5 5 5 5 5 5 5 0 
0 5 5 4 3 5 5 5 5 5 1 1 3 1 1 1 1 1 1 1 1 1 1 3 1 1 1 3 1 1 5 5 5 5 5 3 4 5 5 0 
0 2 2 2 2 2 2 2 2 2 1 1 3 1 1 1 1 1 1 1 1 3 1 1 1 1 1 1 3 1 2 2 2 2 2 2 2 2 2 0 
0 5 5 5 5 5 5 5 5 5 1 1 1 1 1 1 3 1 1 1 3 1 1 1 1 1 1 1 3 1 5 5 5 5 5 5 5 5 5 0 
0 5 5 4 3 5 5 5 5 5 1 1 1 1 3 1 1 1 1 1 1 3 1 3 3 1 1 1 1 1 5 5 5 5 5 3 4 5 5 0 
0 2 2 2 2 2 2 2 2 2 1 3 3 1 1 1 1 1 1 1 1 3 1 3 3 1 1 1 1 1 2 2 2 2 2 2 2 2 2 0 
0 5 5 5 5 5 5 5 5 5 1 1 1 1 3 1 3 1 1 1 1 3 1 1 3 1 1 1 1 1 5 5 5 5 5 5 5 5 5 0 
0 5 5 4 3 5 5 5 5 5 1 1 1 1 3 1 3 1 1 1 1 3 1 1 3 1 1 3 1 1 5 5 5 5 5 3 4 5 5 0 
0 2 2 2 2 2 2 2 2 2 1 3 3 1 3 1 1 3 1 1 1 1 3 1 1 1 3 1 1 1 2 2 2 2 2 2 2 2 2 0 
0 5 5 5 5 5 5 5 5 5 1 3 3 1 3 1 1 3 1 1 1 1 1 1 1 1 1 1 1 1 5 5 5 5 5 5 5 5 5 0 
0 5 5 4 3 5 5 5 5 5 1 1 1 1 3 1 1 3 1 1 1 1 1 1 1 1 3 1 1 1 5 5 5 5 5 3 4 5 5 0 
0 2 2 2 2 2 2 2 2 2 1 1 1 1 1 3 1 1 1 3 1 1 1 1 3 1 1 3 1 1 2 2 2 2 2 2 2 2 2 0 
0 1 1 1 1 3 1 3 1 1 3 1 1 1 1 1 1 1 1 3 1 1 1 1 1 3 1 1 1 1 1 1 1 1 1 1 1 1 3 0 
0 1 1 1 1 1 1 3 1 1 1 1 3 1 1 1 1 3 1 1 3 1 3 1 1 1 3 1 1 3 1 1 1 1 1 1 1 1 1 0 
0 1 1 3 1 1 1 1 3 1 1 1 1 1 3 1 1 1 3 1 1 1 1 1 1 1 3 1 1 3 1 1 1 1 1 1 1 1 1 0 
0 1 1 3 1 1 1 1 1 1 1 1 3 1 1 1 1 1 1 3 1 3 3 1 1 1 1 1 1 1 1 1 3 1 1 1 1 1 1 0 
0 3 1 6 1 1 1 3 1 1 1 1 1 1 1 1 1 1 1 3 1 3 3 1 1 1 1 1 1 1 1 1 3 3 1 1 3 1 10 0 
0 1 1 1 1 3 1 1 1 1 1 1 3 1 3 3 1 1 1 1 1 1 3 1 1 1 1 1 1 1 1 3 1 1 3 1 1 1 1 0 
0 3 3 1 1 1 1 1 1 1 1 1 3 1 3 3 1 1 1 1 1 1 1 1 1 3 1 1 3 1 3 1 3 1 1 3 1 1 1 0 
0 0 0 0 0 0 0 0 0 0 0 0 0 0 0 0 0 0 0 0 0 0 0 0 0 0 0 0 0 0 0 0 0 0 0 0 0 0 0 0 