40 22
0 0 0 0 0 0 0 0 0 0 0 0 0 0 0 0 0 0 0 0 0 0 0 0 0 0 0 0 0 0 0 0 0 0 0 0 0 0 0 0 
0 3 1 2 2 1 2 3 3 1 2 1 1 1 3 2 3 1 1 3 1 1 1 1 2 1 1 1 3 1 1 1 1 1 3 2 1 4 1 0 
0 1 1 6 2 1 4 1 3 1 2 1 1 1 2 2 2 1 1 2 1 3 1 1 1 1 3 1 1 3 1 3 1 1 1 2 1 2 3 0 
0 1 1 1 1 2 1 1 3 4 1 1 3 1 1 1 1 2 1 1 1 1 1 3 1 2 2 3 1 1 1 1 1 1 1 2 1 2 2 0 
0 4 1 2 1 1 2 3 2 3 1 1 3 1 1 1 1 2 1 1 1 3 1 1 1 1 1 1 3 1 3 3 1 1 1 1 1 1 2 0 
0 3 1 2 1 1 1 2 1 1 3 1 2 2 1 1 3 1 2 2 4 1 1 1 1 1 1 1 3 1 3 3 1 1 1 1 1 1 2 0 
0 3 3 1 1 3 1 1 1 1 2 1 1 1 3 1 1 1 1 1 1 3 1 3 3 1 1 1 1 1 1 3 1 1 4 2 2 1 1 0 
0 1 1 3 1 2 2 1 1 3 1 3 3 1 1 1 2 1 1 1 1 3 1 3 1 1 1 1 1 1 1 2 1 1 3 1 2 1 3 0 
0 1 1 2 1 1 1 4 1 1 1 1 1 1 4 1 3 1 1 2 2 3 1 1 3 1 2 1 2 3 1 1 2 3 1 1 4 1 3 0 
0 3 1 3 1 1 1 1 2 1 2 2 1 1 4 1 3 1 1 2 2 3 1 1 3 1 1 4 1 2 1 1 1 2 1 1 3 1 2 0 
0 1 3 1 2 2 1 1 1 1 1 3 3 2 3 1 1 4 1 2 1 2 3 1 1 2 3 1 1 1 2 3 1 1 4 1 3 1 1 0 
0 2 1 2 2 1 1 1 1 1 1 3 3 2 3 1 1 3 1 2 1 2 2 1 1 1 2 1 1 3 1 2 2 1 1 3 1 2 2 0 
0 1 2 1 3 1 3 1 2 1 1 1 2 2 3 1 1 3 1 1 1 1 2 1 1 1 3 1 1 1 1 1 2 2 1 3 1 2 10 0 
0 1 2 1 3 1 3 1 2 1 4 1 2 1 2 3 1 1 2 3 1 1 1 1 3 1 1 3 1 3 3 1 1 1 1 2 1 1 1 0 
0 2 1 1 2 3 2 3 1 1 3 1 1 1 1 2 1 1 1 4 1 1 1 2 1 3 2 1 1 1 1 1 1 2 1 2 2 1 4 0 
0 2 1 1 1 2 2 3 1 1 2 1 4 1 1 1 2 3 1 1 3 1 3 1 1 1 3 1 2 3 1 1 1 1 1 1 2 1 1 0 
0 2 1 4 1 1 1 1 3 1 2 2 1 1 3 1 2 2 3 1 1 1 1 1 1 1 3 1 2 3 1 1 1 1 1 1 2 1 1 0 
0 1 1 3 1 1 1 1 2 1 1 1 3 1 1 1 1 1 1 3 1 3 3 1 1 1 1 1 1 2 1 1 3 1 2 1 1 1 2 0 
0 3 1 2 2 1 1 3 1 2 2 1 1 1 2 1 1 1 1 3 1 3 3 1 1 1 1 1 1 2 1 1 3 4 1 1 3 1 1 0 
0 2 1 1 1 3 1 1 1 1 1 1 3 1 3 4 1 1 1 1 1 1 3 1 1 1 2 2 1 1 2 3 1 1 4 1 2 1 1 0 
0 3 3 1 1 1 2 1 1 1 1 1 3 1 3 4 1 1 1 1 1 1 2 1 1 3 1 2 4 1 4 1 3 2 1 3 1 1 1 0 
0 0 0 0 0 0 0 0 0 0 0 0 0 0 0 0 0 0 0 0 0 0 0 0 0 0 0 0 0 0 0 0 0 0 0 0 0 0 0 0 