40 22
0 0 0 0 0 0 0 0 0 0 0 0 0 0 0 0 0 0 0 0 0 0 0 0 0 0 0 0 0 0 0 0 0 0 0 0 0 0 0 0 
0 1 5 1 1 5 1 3 3 1 1 1 1 1 5 1 1 3 1 5 6 1 1 1 1 5 3 3 5 3 1 1 3 1 5 1 5 5 1 0 
0 5 1 1 3 1 5 1 1 5 1 5 5 1 1 1 1 5 1 3 1 3 1 5 1 1 1 5 5 3 1 1 3 1 4 1 1 5 1 0 
0 3 1 1 1 1 1 5 5 1 3 1 5 5 1 1 1 5 1 3 1 3 1 5 1 1 1 5 2 2 2 2 2 2 2 2 2 2 2 0 
0 1 3 1 4 1 1 1 5 1 5 5 1 1 1 1 1 1 5 1 1 3 3 1 1 3 1 1 1 1 5 1 5 1 1 1 5 1 5 0 
0 2 2 2 2 2 2 2 2 2 2 2 2 1 3 1 5 1 1 5 5 5 3 1 1 5 1 1 1 1 5 1 1 1 3 1 1 1 1 0 
0 3 1 5 3 1 1 1 1 1 1 5 1 1 3 1 5 1 1 1 5 1 1 3 1 5 5 1 1 3 1 5 5 3 1 1 1 1 1 0 
0 3 1 5 3 1 1 1 1 1 1 5 1 1 5 3 1 1 3 1 1 1 1 5 1 1 1 3 1 1 1 1 1 1 3 1 3 3 1 0 
0 1 1 1 5 1 1 3 5 5 1 1 1 5 1 1 3 1 5 5 1 1 3 1 5 5 1 1 1 5 1 1 1 1 3 1 3 3 1 0 
0 1 1 1 5 1 1 3 1 5 1 3 1 1 1 1 5 1 1 1 3 1 1 1 1 1 1 3 1 3 1 1 5 5 3 1 1 3 1 0 
0 5 5 1 1 5 3 1 1 1 1 5 1 1 3 1 3 1 1 1 1 5 1 5 5 1 1 1 1 1 1 1 5 5 4 1 1 5 1 0 
0 1 5 1 1 1 5 1 1 5 1 5 5 1 1 5 1 5 5 1 1 1 1 1 3 3 5 3 1 1 3 1 5 1 5 3 1 1 5 0 
0 1 1 5 4 1 1 3 1 3 1 1 1 1 5 1 5 5 1 1 1 1 1 1 3 5 5 3 1 1 3 1 5 1 5 5 1 1 1 0 
0 1 3 1 5 5 1 1 3 1 5 5 1 1 1 5 1 3 1 3 1 5 1 1 1 5 5 3 1 1 5 1 1 1 1 5 1 1 1 0 
0 1 1 1 1 5 5 1 3 1 5 5 1 1 1 5 1 3 1 3 1 5 1 3 1 5 1 5 3 1 1 5 3 1 1 1 1 5 1 0 
0 1 5 5 1 1 1 1 5 1 1 1 1 5 5 1 1 5 3 5 3 1 1 3 1 1 1 1 5 1 1 1 3 1 1 1 5 1 3 0 
0 1 1 1 1 1 5 1 5 5 1 3 3 1 5 1 1 1 5 5 3 1 1 5 1 3 1 1 1 5 3 1 1 3 1 3 1 1 1 0 
0 5 3 1 1 1 1 1 1 5 1 1 3 1 5 1 3 1 1 1 1 5 1 1 10 1 1 3 1 5 5 3 1 1 1 1 1 1 1 0 
0 5 3 1 1 1 1 1 1 5 1 1 5 3 1 1 3 1 1 1 1 5 1 1 1 3 1 1 1 1 1 1 3 1 3 3 1 1 1 0 
0 1 5 1 1 3 1 5 1 1 1 5 1 1 3 1 5 5 1 4 4 1 5 5 1 1 1 5 1 1 1 1 3 1 3 3 1 1 1 0 
0 1 5 1 4 3 3 1 1 3 1 1 1 1 5 1 1 1 3 1 1 1 1 1 1 3 1 3 3 1 1 1 1 1 4 3 1 1 1 0 
0 0 0 0 0 0 0 0 0 0 0 0 0 0 0 0 0 0 0 0 0 0 0 0 0 0 0 0 0 0 0 0 0 0 0 0 0 0 0 0 